less = меньше
boring = скучный
interesting = интересный
seem = казаться
explain = объяснять
as soon as possible = как можно скорее
have a rest = отдыхать(в 3 слова)
relax = отдыхать(в 1 слово)
decision = решение 
listen to music = слушать музыку
enough = достаточно
knowledge = знания 
look for = искать
pay for = платить за
sometimes = иногда
often = часто 
hear = слышать
hate = ненавидеть
ignore = игнорировать 
usually = обычно
always = всегда 
from time to time = время от времени
project = проект 
profession = профессия 
look = выглядеть 
strange = странный 
useless = бесполезный
important = важный
unimportant = не важный
difficult = сложный
easy = легкий
test = тест
very = очень
understand = понимать
truth = правда
show = показывать
excellent = отличный
results = результаты
excellent results = отличные результаты
brilliant = блестящий
brilliant results = блестящие результаты
mistake = ошибка
make mistakes = делать ошибки
correctly = правильно, корректно
support = поддерживать
speak English fluently = говорить по английски свободно
want = хотеть
need = нужно(необходимость)
exercise = упражнение
depend = зависеть
depend on = зависеть от
too = слишком
believe = верить
control = контролировать
situation = ситуация
boss = босс
teacher = учитель
correct = исправлять
help = помогать(помощь)
person = человек
our = наш
information = информация
friend = друг
far = далеко
near = радом(около)
cost = стоить
feel = чувствовать себя
spend time = проводить время
together = вместе
where = где(куда) ?
why = почему ?
what = что(какой) ?
find = находить
get to = добираться до
time = время
free time = свободное время
prefer = предпочитать
kind of = вид чего-то... 
kind of = вид чего-то... 
what time = в какое время(во сколько) ?
get up = встать
go to bed = идти спать
money = деньги
how much = как много, сколько(с не исчисляемыми*) ?
how many = как много, сколько(с исчисляемыми*) ?
